15
15
...............
...............
...............
.   ...gg......
.   b b g......
..... .  ......
..... . .......
.... b  .......
...   . .......
s    .. .......
...... b.......
......    .....
...... g. .....
......... .....
.........x.....
