15
15
.........s.....
......        .
......        .
......        x
.....         .
.  .. ..    ...
.  .. .... ....
. b  bgg   ....
.g  .  ........
... ...........
... ...........
... b .........
...   .........
...............
...............
