15
15
...............
....... g......
....... g......
s    .. g......
....     ......
.......   ..  x
........ .. b .
. b c c  .    .
.       c b  ..
.......  ......
...............
...............
...............
...............
...............
