15
15
...............
...............
...............
s       .......
.......   .....
..... . c     x
....gcbbcg.....
.....    ......
....... .......
.. c  c  ......
.        ......
.   ...........
...............
...............
...............
