15
15
...............
...............
...............
...............
...............
s             x
. c .......c...
... ..  g.    .
...    b b    .
... .. .bc.....
...e.. c   ....
.........g.....
.........g.....
...............
...............