15
15
.......x.......
......   ......
...... b ......
....   ........
.... .b.....  .
....     ...  .
......  c     .
......g......b.
......g....   .
...    ...  . .
..  .. c   .. .
. cb . . .  eg.
.g    e. . ....
........      s
...............
