15
15
...............
...............
.... ..........
.. cc..........
.  c         ..
.. ........   .
.  ...  ...   .
.  ..    ... ..
.   .    ... ..
.   .. . ... ..
... ..c.c... ..
... .    c    .
..  g.b ...   x
.    c   ......
.......s.......
