15
15
...............
..........  ...
..........b ...
..........  ...
..........    .
..........c.. .
.......... .. .
..........    x
.......... ....
.......... ....
. b  c      ...
. b   .  ggg...
s cb ...c.g....
.        ......
...............
