15
15
....x..........
.            e.
. ..... ..... .
. .   . .  g. .
. .   . c   . .
. . b . .   . .
. ...c. .c... x
s      .      .
. ...c. .c... .
. .   c c   . .
. . b . .   . .
. .   . .g  . .
. ..... ..... .
.             .
...............
